N N N V N V N N N N N N
N V N N N N N N N D N N
N N D V N V N N N N N N
N V N N N N N N N N N N
N N N V N D N N N N N N
N V N N N N N N N N N N
N V N V N N N N D N N N
N N N N N N N N N N N N
N D D D N N N N N N N N
N N N N N N N N N D N N
N D N D N N N N N N N N
N N N N N N N N N N N N