N N N V N V N N N N N N
N V N N N N N N N D N N
N N D V N V N N N N N N
N V N N N N N N N D N N
N N D V N V N V N N N N
N V N N N N N N N D N N
N V D V N N N N N N N N
N N N N N N N N N D N N
N D D D N V N N N N N N
N N N N N N N N N D N N
N D N D N V N V N N N N
N N D N N N N N N N N N