N N V V V V N N N N V N
N N N N N N N N N N N N
N N D N N N N N N N N V
N N N D D D D D D D N N
N N N N N N D N N N N V
N V N N N N D N N N N N
N V N V N N D N V N N V
N N N N N N D N N N N N
N N N N N N N N N N N V
N N N N N N N N N D N N
N N N N N N N N N N N N
N N N N N N N N N N N N